..................T........
....T......T...T.X..T......
........T....T....T........
...T..T....................
..............H............
..T.......X.@............T.
....T......#...............
.T.T...................T...
..........T......T.........
...............T...........
......T....................
...........................
